//MAP CONVERTED BY dmm2tgm.py THIS HEADER COMMENT PREVENTS RECONVERSION, DO NOT REMOVE
"a" = (
/obj/machinery/atmospherics/pipe/manifold/orange/hidden{
	dir = 4
	},
/turf/closed/wall/mineral/bananium,
/area/ship/crew/toilet)
"b" = (
/obj/machinery/power/shuttle/engine/fueled/plasma{
	dir = 4
	},
/turf/open/floor/plating/airless,
/area/ship/crew/toilet)
"e" = (
/obj/machinery/atmospherics/pipe/simple/orange/hidden{
	dir = 1
	},
/turf/closed/wall/mineral/bananium,
/area/ship/crew/toilet)
"h" = (
/obj/effect/decal/cleanable/dirt,
/obj/machinery/atmospherics/components/binary/pump{
	dir = 1;
	name = "engine fuel pump"
	},
/obj/machinery/power/apc/auto_name/east,
/obj/structure/cable{
	icon_state = "0-8"
	},
/obj/item/storage/toolbox/mechanical/old,
/turf/open/floor/mineral/bananium,
/area/ship/crew/toilet)
"j" = (
/obj/machinery/power/port_gen/pacman,
/obj/item/stack/sheet/mineral/plasma/fifty,
/obj/structure/cable{
	icon_state = "0-4"
	},
/obj/machinery/button/door{
	id = "goofy_bolt";
	name = "External Bolt Control";
	normaldoorcontrol = 1;
	pixel_x = -25;
	specialfunctions = 4;
	dir = 4
	},
/obj/effect/decal/cleanable/dirt,
/turf/open/floor/mineral/bananium,
/area/ship/crew/toilet)
"k" = (
/obj/effect/decal/cleanable/dirt,
/obj/docking_port/mobile{
	callTime = 50;
	dir = 4;
	ignitionTime = 25;
	name = "Syndicate Fighter";
	port_direction = 2;
	preferred_direction = 4
	},
/obj/machinery/door/airlock/bananium{
	id_tag = "caravansyndicate1_bolt"
	},
/obj/effect/mapping_helpers/airlock/locked,
/obj/structure/fans/tiny,
/turf/open/floor/mineral/bananium,
/area/ship/crew/toilet)
"p" = (
/obj/effect/decal/cleanable/dirt,
/obj/effect/decal/cleanable/dirt,
/obj/machinery/atmospherics/pipe/simple/orange/hidden,
/turf/open/floor/mineral/bananium,
/area/ship/crew/toilet)
"q" = (
/turf/template_noop,
/area/template_noop)
"r" = (
/obj/machinery/atmospherics/pipe/simple/orange/hidden{
	dir = 4
	},
/turf/closed/wall/mineral/bananium,
/area/ship/crew/toilet)
"w" = (
/obj/structure/fluff/oldturret,
/turf/closed/wall/mineral/bananium,
/area/ship/crew/toilet)
"C" = (
/obj/machinery/computer/helm,
/turf/open/floor/mineral/bananium,
/area/ship/crew/toilet)
"D" = (
/obj/machinery/atmospherics/components/unary/shuttle/heater{
	dir = 4
	},
/turf/closed/wall/mineral/bananium,
/area/ship/crew/toilet)
"I" = (
/obj/machinery/atmospherics/pipe/simple/orange/hidden{
	dir = 1
	},
/obj/structure/window/fulltile,
/turf/open/floor/plating/airless,
/area/ship/crew/toilet)
"K" = (
/obj/machinery/atmospherics/components/unary/portables_connector{
	dir = 1
	},
/obj/machinery/portable_atmospherics/canister/toxins,
/turf/open/floor/mineral/bananium,
/area/ship/crew/toilet)
"M" = (
/turf/open/floor/mineral/bananium,
/area/ship/crew/toilet)
"P" = (
/obj/effect/decal/cleanable/dirt,
/obj/item/radio/intercom/wideband{
	pixel_y = 26
	},
/obj/machinery/cryopod{
	dir = 4
	},
/obj/machinery/computer/cryopod{
	dir = 4;
	pixel_x = -23
	},
/turf/open/floor/mineral/bananium,
/area/ship/crew/toilet)
"S" = (
/obj/machinery/atmospherics/pipe/simple/orange/hidden{
	dir = 10
	},
/turf/closed/wall/mineral/bananium,
/area/ship/crew/toilet)
"T" = (
/obj/machinery/atmospherics/pipe/simple/orange/hidden{
	dir = 9
	},
/turf/closed/wall/mineral/bananium,
/area/ship/crew/toilet)
"V" = (
/obj/effect/decal/cleanable/dirt,
/obj/machinery/atmospherics/pipe/simple/orange/hidden{
	dir = 6
	},
/obj/structure/chair/comfy/shuttle{
	dir = 1
	},
/turf/open/floor/mineral/bananium,
/area/ship/crew/toilet)
"Z" = (
/turf/closed/wall/mineral/bananium,
/area/ship/crew/toilet)

(1,1,1) = {"
q
b
Z
Z
k
Z
Z
b
q
"}
(2,1,1) = {"
q
D
Z
P
M
j
Z
D
q
"}
(3,1,1) = {"
Z
r
C
V
p
h
K
r
Z
"}
(4,1,1) = {"
Z
S
e
a
I
e
e
T
Z
"}
(5,1,1) = {"
w
q
q
q
q
q
q
q
w
"}
