//MAP CONVERTED BY dmm2tgm.py THIS HEADER COMMENT PREVENTS RECONVERSION, DO NOT REMOVE
"a" = (
/obj/machinery/power/smes/shuttle/precharged{
	dir = 4
	},
/obj/structure/window/reinforced/spawner,
/obj/structure/window/reinforced/spawner{
	dir = 1
	},
/obj/structure/window/reinforced/spawner/west,
/obj/structure/cable{
	icon_state = "0-8"
	},
/turf/open/floor/plasteel/tech,
/area/ship/construction)
"b" = (
/obj/structure/window/reinforced/spawner/east,
/obj/machinery/computer/helm{
	dir = 8
	},
/turf/open/floor/plasteel/tech,
/area/ship/construction)
"c" = (
/obj/effect/decal/cleanable/blood/drip,
/turf/open/floor/plasteel/tech,
/area/ship/construction)
"h" = (
/obj/effect/decal/cleanable/vomit,
/turf/open/floor/plasteel/tech,
/area/ship/construction)
"j" = (
/obj/structure/window/reinforced/spawner{
	dir = 1
	},
/obj/structure/window/reinforced/spawner/east,
/obj/machinery/computer/cargo/express{
	dir = 8
	},
/turf/open/floor/plasteel/tech,
/area/ship/construction)
"n" = (
/obj/structure/window/reinforced/spawner,
/obj/structure/window/reinforced/spawner/east,
/obj/structure/closet/crate/engineering,
/obj/item/circuitboard/machine/selling_pad,
/obj/item/circuitboard/computer/selling_pad_control,
/obj/item/circuitboard/machine/protolathe,
/obj/item/circuitboard/machine/circuit_imprinter,
/obj/item/circuitboard/computer/rdconsole,
/turf/open/floor/plasteel/tech,
/area/ship/construction)
"o" = (
/obj/structure/window/reinforced/spawner{
	dir = 1
	},
/obj/machinery/mineral/ore_redemption{
	dir = 4;
	input_dir = 8;
	output_dir = 4
	},
/turf/open/floor/plasteel/tech,
/area/ship/construction)
"p" = (
/obj/machinery/door/window/westright{
	dir = 1
	},
/obj/docking_port/mobile{
	callTime = 250;
	launch_status = 0;
	name = "Tablet-class";
	port_direction = 8;
	dir = 2;
	preferred_direction = 4
	},
/obj/effect/decal/cleanable/blood/tracks,
/turf/open/floor/plasteel/tech,
/area/ship/construction)
"r" = (
/obj/structure/cable{
	icon_state = "2-8"
	},
/obj/effect/decal/cleanable/blood/drip,
/turf/open/floor/plasteel/tech,
/area/ship/construction)
"u" = (
/obj/machinery/power/terminal{
	dir = 8
	},
/obj/structure/window/reinforced/spawner{
	dir = 1
	},
/obj/structure/cable{
	icon_state = "0-4"
	},
/obj/effect/decal/cleanable/greenglow,
/turf/open/floor/plasteel/tech,
/area/ship/construction)
"w" = (
/turf/open/floor/plasteel/tech,
/area/ship/construction)
"x" = (
/obj/machinery/power/shuttle/engine/electric{
	dir = 4
	},
/obj/structure/cable{
	icon_state = "0-4"
	},
/turf/open/floor/plasteel/tech,
/area/ship/construction)
"B" = (
/obj/structure/window/reinforced/spawner,
/obj/effect/decal/cleanable/blood/drip,
/turf/open/floor/plasteel/tech,
/area/ship/construction)
"C" = (
/obj/machinery/power/smes/engineering{
	charge = 1e+006
	},
/obj/structure/window/reinforced/spawner{
	dir = 1
	},
/obj/structure/window/reinforced/spawner/west,
/obj/structure/cable{
	icon_state = "0-2"
	},
/turf/open/floor/plasteel/tech,
/area/ship/construction)
"E" = (
/obj/structure/window/reinforced/spawner,
/obj/structure/closet/crate/wooden,
/obj/item/pickaxe/improvised,
/obj/item/mining_scanner,
/obj/item/storage/bag/ore,
/obj/item/storage/toolbox/mechanical,
/obj/item/tank/internals/oxygen,
/obj/item/tank/internals/oxygen,
/obj/item/clothing/head/helmet/space,
/obj/item/clothing/suit/space/eva,
/obj/item/areaeditor/shuttle,
/turf/open/floor/plasteel/tech,
/area/ship/construction)
"H" = (
/obj/structure/window/reinforced/spawner{
	dir = 1
	},
/obj/item/radio/intercom/wideband,
/turf/open/floor/plasteel/tech,
/area/ship/construction)
"J" = (
/turf/closed/wall,
/area/ship/construction)
"K" = (
/obj/machinery/holopad/emergency/command,
/turf/open/floor/plasteel/tech,
/area/ship/construction)
"O" = (
/obj/structure/window/reinforced/spawner,
/obj/machinery/cryopod{
	dir = 1
	},
/turf/open/floor/plasteel/tech,
/area/ship/construction)
"S" = (
/obj/structure/window/reinforced/spawner,
/obj/machinery/power/apc/auto_name/west,
/obj/structure/cable,
/turf/open/floor/plasteel/tech,
/area/ship/construction)
"V" = (
/turf/template_noop,
/area/template_noop)
"X" = (
/obj/structure/window/reinforced/spawner,
/obj/machinery/autolathe,
/turf/open/floor/plasteel/tech,
/area/ship/construction)
"Y" = (
/obj/structure/window/reinforced/spawner{
	dir = 1
	},
/obj/machinery/power/port_gen/pacman{
	anchored = 1
	},
/obj/item/stack/sheet/mineral/plasma/five,
/obj/structure/cable{
	icon_state = "0-8"
	},
/turf/open/floor/plasteel/tech,
/area/ship/construction)
"Z" = (
/obj/machinery/power/terminal{
	dir = 8
	},
/obj/machinery/door/window/eastleft{
	dir = 8
	},
/obj/structure/cable{
	icon_state = "0-4"
	},
/obj/structure/cable{
	icon_state = "1-4"
	},
/obj/machinery/computer/cryopod{
	pixel_y = -22;
	dir = 1;
	pixel_x = -3
	},
/turf/open/floor/plasteel/tech,
/area/ship/construction)

(1,1,1) = {"
V
x
V
"}
(2,1,1) = {"
V
a
V
"}
(3,1,1) = {"
C
Z
J
"}
(4,1,1) = {"
u
r
S
"}
(5,1,1) = {"
Y
w
E
"}
(6,1,1) = {"
p
h
O
"}
(7,1,1) = {"
o
K
X
"}
(8,1,1) = {"
H
c
B
"}
(9,1,1) = {"
j
b
n
"}
