//MAP CONVERTED BY dmm2tgm.py THIS HEADER COMMENT PREVENTS RECONVERSION, DO NOT REMOVE
"aR" = (
/obj/machinery/atmospherics/pipe/manifold/scrubbers/hidden/layer4,
/turf/open/floor/plasteel/dark,
/area/ship/cargo)
"aU" = (
/obj/structure/table,
/obj/item/storage/firstaid/regular,
/obj/item/storage/backpack/duffelbag/med/surgery,
/obj/machinery/atmospherics/pipe/simple/scrubbers/hidden/layer4{
	dir = 1
	},
/turf/open/floor/plasteel/dark,
/area/ship/medical)
"aV" = (
/obj/structure/tank_dispenser/oxygen,
/turf/open/floor/plasteel/dark,
/area/ship/engineering)
"aW" = (
/obj/machinery/atmospherics/components/binary/pump{
	dir = 8;
	name = "engine fuel pump"
	},
/obj/structure/catwalk/over,
/obj/structure/cable/yellow{
	icon_state = "4-8"
	},
/turf/open/floor/plating,
/area/ship/engineering)
"by" = (
/obj/effect/turf_decal/corner/opaque/syndiered/diagonal,
/obj/machinery/atmospherics/pipe/simple/scrubbers/hidden/layer4{
	dir = 4
	},
/turf/open/floor/plasteel/dark,
/area/ship/cargo)
"bZ" = (
/obj/machinery/atmospherics/pipe/simple/orange/hidden{
	dir = 9
	},
/obj/structure/catwalk/over,
/turf/open/floor/plating,
/area/ship/engineering)
"cK" = (
/obj/machinery/ore_silo,
/obj/effect/turf_decal/corner/opaque/syndiered/diagonal,
/turf/open/floor/plasteel/dark,
/area/ship/cargo)
"cR" = (
/obj/structure/cable/yellow{
	icon_state = "1-2"
	},
/obj/effect/turf_decal/corner/opaque/syndiered/diagonal,
/obj/machinery/atmospherics/pipe/simple/supply/hidden/layer2,
/turf/open/floor/plasteel/dark,
/area/ship/medical)
"di" = (
/obj/machinery/suit_storage_unit/inherit/industrial,
/obj/item/clothing/suit/space/hardsuit/syndi/scarlet,
/obj/item/clothing/mask/breath,
/obj/effect/turf_decal/corner/opaque/syndiered/diagonal,
/turf/open/floor/plasteel/dark,
/area/ship/engineering)
"dk" = (
/obj/structure/window/reinforced/spawner/west,
/obj/machinery/atmospherics/components/unary/shuttle/heater{
	dir = 4
	},
/turf/open/floor/plasteel/dark,
/area/ship/engineering)
"do" = (
/obj/machinery/atmospherics/pipe/simple/orange/hidden{
	dir = 4
	},
/obj/structure/catwalk/over,
/turf/open/floor/plating,
/area/ship/engineering)
"dQ" = (
/obj/machinery/suit_storage_unit/inherit/industrial,
/obj/item/clothing/suit/space/hardsuit/syndi/scarlet,
/obj/item/clothing/mask/breath,
/obj/machinery/light{
	dir = 4
	},
/turf/open/floor/plasteel/dark,
/area/ship/engineering)
"dR" = (
/obj/machinery/sleeper/syndie,
/obj/machinery/airalarm/all_access{
	pixel_y = 25
	},
/turf/open/floor/plasteel/dark,
/area/ship/medical)
"eA" = (
/obj/machinery/atmospherics/components/unary/vent_pump/on/layer2{
	dir = 8
	},
/turf/open/floor/plasteel/dark,
/area/ship/bridge)
"fg" = (
/obj/machinery/light{
	dir = 8
	},
/turf/open/floor/plasteel/dark,
/area/ship/cargo)
"fh" = (
/obj/structure/cable/yellow{
	icon_state = "1-2"
	},
/obj/machinery/atmospherics/pipe/simple/scrubbers/hidden/layer4{
	dir = 9
	},
/obj/machinery/atmospherics/pipe/simple/supply/hidden/layer2,
/turf/open/floor/plasteel/dark,
/area/ship/engineering)
"fM" = (
/obj/machinery/suit_storage_unit/inherit{
	name = "captain's suit storage unit";
	req_access_txt = "20"
	},
/obj/item/clothing/suit/space/hardsuit/syndi,
/obj/item/clothing/mask/gas/syndicate,
/obj/effect/turf_decal/corner/opaque/syndiered/diagonal,
/turf/open/floor/plasteel/dark,
/area/ship/bridge)
"fR" = (
/obj/machinery/door/airlock/medical/glass,
/obj/structure/cable/yellow{
	icon_state = "4-8"
	},
/obj/machinery/atmospherics/pipe/simple/scrubbers/hidden/layer4{
	dir = 4
	},
/obj/machinery/atmospherics/pipe/simple/supply/hidden/layer2{
	dir = 4
	},
/turf/open/floor/plasteel/dark,
/area/ship/medical)
"gl" = (
/obj/machinery/atmospherics/components/unary/vent_scrubber/on/layer4{
	dir = 4
	},
/turf/open/floor/plasteel/dark,
/area/ship/cargo)
"gz" = (
/obj/effect/turf_decal/corner/opaque/syndiered/diagonal,
/obj/machinery/atmospherics/pipe/simple/supply/hidden/layer2{
	dir = 6
	},
/turf/open/floor/plasteel/dark,
/area/ship/cargo)
"gD" = (
/obj/structure/cable/yellow{
	icon_state = "4-8"
	},
/obj/effect/turf_decal/corner/opaque/syndiered/diagonal,
/turf/open/floor/plasteel/dark,
/area/ship/engineering)
"gK" = (
/obj/machinery/atmospherics/pipe/simple/supply/hidden/layer2{
	dir = 9
	},
/turf/open/floor/plasteel/dark,
/area/ship/engineering)
"gN" = (
/obj/machinery/door/poddoor{
	id = "rundowncargo";
	name = "IMS-730 Bay Blast Door"
	},
/obj/machinery/power/shieldwallgen/atmos/roundstart{
	dir = 1;
	id = "hyena_cargo";
	locked = 1
	},
/obj/structure/cable/yellow{
	icon_state = "0-8"
	},
/turf/open/floor/plasteel/dark,
/area/ship/engineering)
"hO" = (
/obj/machinery/atmospherics/components/unary/vent_pump/on/layer2{
	dir = 4
	},
/turf/open/floor/plasteel/dark,
/area/ship/engineering)
"iJ" = (
/obj/structure/closet/crate/wooden,
/obj/item/kinetic_crusher/syndie_crusher,
/obj/item/kinetic_crusher/syndie_crusher,
/obj/item/t_scanner/adv_mining_scanner/lesser,
/obj/item/t_scanner/adv_mining_scanner/lesser,
/obj/item/storage/bag/ore,
/obj/item/storage/bag/ore,
/obj/machinery/light/small{
	dir = 1
	},
/obj/item/clothing/glasses/meson,
/obj/item/clothing/glasses/meson,
/obj/item/gps/mining,
/obj/item/gps/mining,
/obj/item/pickaxe,
/obj/item/pickaxe,
/turf/open/floor/plasteel/dark,
/area/ship/cargo)
"iP" = (
/obj/structure/cable/yellow{
	icon_state = "4-8"
	},
/obj/effect/turf_decal/corner/opaque/syndiered/diagonal,
/obj/machinery/atmospherics/pipe/simple/scrubbers/hidden/layer4{
	dir = 9
	},
/obj/machinery/atmospherics/pipe/simple/supply/hidden/layer2{
	dir = 4
	},
/turf/open/floor/plasteel/dark,
/area/ship/medical)
"iW" = (
/turf/open/floor/plasteel/dark,
/area/ship/engineering)
"jb" = (
/obj/machinery/power/apc/auto_name/west,
/obj/structure/cable/yellow,
/obj/effect/turf_decal/corner/opaque/syndiered/diagonal,
/turf/open/floor/plasteel/dark,
/area/ship/bridge)
"jf" = (
/obj/machinery/holopad/emergency,
/obj/effect/turf_decal/corner/opaque/syndiered/diagonal,
/turf/open/floor/plasteel/dark,
/area/ship/bridge)
"kj" = (
/obj/machinery/power/apc/auto_name/north,
/obj/structure/cable/yellow{
	icon_state = "0-2"
	},
/obj/effect/turf_decal/corner/opaque/syndiered/diagonal,
/turf/open/floor/plasteel/dark,
/area/ship/medical)
"lb" = (
/obj/structure/cable/yellow{
	icon_state = "1-8"
	},
/obj/effect/turf_decal/corner/opaque/syndiered/diagonal,
/obj/machinery/atmospherics/pipe/simple/supply/hidden/layer2,
/turf/open/floor/plasteel/dark,
/area/ship/engineering)
"lj" = (
/obj/machinery/atmospherics/components/unary/tank/air{
	piping_layer = 2
	},
/turf/open/floor/plasteel/dark,
/area/ship/engineering)
"me" = (
/obj/machinery/power/terminal{
	dir = 8
	},
/obj/structure/cable{
	icon_state = "0-4"
	},
/turf/open/floor/plasteel/dark,
/area/ship/engineering)
"mh" = (
/obj/effect/spawner/structure/window/plasma/reinforced/plastitanium,
/turf/open/floor/plating,
/area/ship/bridge)
"mx" = (
/obj/effect/spawner/structure/window/plasma/reinforced/plastitanium,
/turf/open/floor/plating,
/area/ship/medical)
"nZ" = (
/obj/structure/table,
/obj/item/storage/belt/utility,
/obj/effect/turf_decal/corner/opaque/syndiered/diagonal,
/obj/machinery/airalarm/all_access{
	pixel_y = 25
	},
/turf/open/floor/plasteel/dark,
/area/ship/cargo)
"oX" = (
/obj/machinery/door/airlock/command/glass/lp/bridge{
	req_access = null
	},
/obj/structure/cable/yellow{
	icon_state = "4-8"
	},
/obj/machinery/atmospherics/pipe/simple/scrubbers/hidden/layer4{
	dir = 8
	},
/obj/machinery/atmospherics/pipe/simple/supply/hidden/layer2{
	dir = 4
	},
/turf/open/floor/plasteel/dark,
/area/ship/bridge)
"pH" = (
/obj/machinery/atmospherics/pipe/manifold/orange/hidden{
	dir = 8
	},
/obj/structure/catwalk/over,
/obj/structure/cable/yellow{
	icon_state = "4-8"
	},
/turf/open/floor/plating,
/area/ship/engineering)
"pM" = (
/obj/effect/turf_decal/corner/opaque/syndiered/diagonal,
/obj/machinery/atmospherics/pipe/simple/scrubbers/hidden/layer4{
	dir = 10
	},
/turf/open/floor/plasteel/dark,
/area/ship/cargo)
"qz" = (
/obj/structure/catwalk/over,
/obj/structure/cable/yellow{
	icon_state = "1-2"
	},
/obj/machinery/atmospherics/pipe/manifold/orange/hidden{
	dir = 1
	},
/turf/open/floor/plating,
/area/ship/engineering)
"qD" = (
/turf/closed/wall/mineral/plastitanium,
/area/ship/cargo)
"rx" = (
/obj/structure/chair/comfy/shuttle{
	dir = 1
	},
/turf/open/floor/plasteel/dark,
/area/ship/cargo)
"rN" = (
/obj/structure/cable/yellow{
	icon_state = "2-8"
	},
/obj/machinery/atmospherics/pipe/simple/scrubbers/hidden/layer4{
	dir = 8
	},
/obj/machinery/atmospherics/pipe/simple/supply/hidden/layer2{
	dir = 4
	},
/turf/open/floor/plasteel/dark,
/area/ship/bridge)
"sz" = (
/obj/machinery/atmospherics/pipe/simple/scrubbers/hidden/layer4{
	dir = 8
	},
/turf/open/floor/plating,
/area/ship/external)
"tJ" = (
/obj/effect/turf_decal/corner/opaque/syndiered/diagonal,
/obj/machinery/atmospherics/pipe/simple/supply/hidden/layer2{
	dir = 5
	},
/turf/open/floor/plasteel/dark,
/area/ship/engineering)
"vi" = (
/obj/machinery/power/apc/auto_name/west,
/obj/structure/cable/yellow{
	icon_state = "0-2"
	},
/obj/structure/cable/yellow{
	icon_state = "2-4"
	},
/turf/open/floor/plasteel/dark,
/area/ship/engineering)
"vG" = (
/obj/machinery/door/airlock/mining/glass,
/obj/structure/cable/yellow{
	icon_state = "1-2"
	},
/obj/machinery/atmospherics/pipe/simple/scrubbers/hidden/layer4,
/obj/machinery/atmospherics/pipe/simple/supply/hidden/layer2,
/turf/open/floor/plasteel/dark,
/area/ship/engineering)
"wi" = (
/obj/machinery/atmospherics/components/unary/tank/toxins{
	dir = 8
	},
/obj/structure/catwalk/over,
/obj/structure/cable/yellow{
	icon_state = "4-8"
	},
/turf/open/floor/plating,
/area/ship/engineering)
"wj" = (
/obj/effect/turf_decal/corner/opaque/syndiered/diagonal,
/turf/open/floor/plasteel/dark,
/area/ship/medical)
"wm" = (
/obj/machinery/atmospherics/components/unary/vent_scrubber/on/layer4{
	dir = 4
	},
/turf/open/floor/plasteel/dark,
/area/ship/bridge)
"wp" = (
/obj/machinery/light{
	dir = 4
	},
/obj/effect/turf_decal/corner/opaque/syndiered/diagonal,
/obj/machinery/atmospherics/components/unary/vent_pump/on/layer2{
	dir = 8
	},
/turf/open/floor/plasteel/dark,
/area/ship/medical)
"wt" = (
/turf/closed/wall/mineral/plastitanium,
/area/ship/engineering)
"wL" = (
/obj/machinery/power/smes/engineering,
/obj/structure/cable/yellow,
/obj/machinery/light{
	dir = 8
	},
/turf/open/floor/plasteel/dark,
/area/ship/engineering)
"xD" = (
/obj/machinery/power/port_gen/pacman{
	anchored = 1
	},
/obj/item/stack/sheet/mineral/plasma/five,
/obj/structure/cable{
	icon_state = "0-8"
	},
/obj/effect/turf_decal/corner/opaque/syndiered/diagonal,
/turf/open/floor/plasteel/dark,
/area/ship/engineering)
"xP" = (
/obj/item/radio/intercom/wideband{
	pixel_y = -29;
	dir = 1
	},
/obj/effect/turf_decal/corner/opaque/syndiered/diagonal,
/turf/open/floor/plasteel/dark,
/area/ship/bridge)
"zz" = (
/obj/effect/turf_decal/corner/opaque/syndiered/diagonal,
/obj/machinery/airalarm/all_access{
	dir = 8;
	pixel_x = 24
	},
/turf/open/floor/plasteel/dark,
/area/ship/bridge)
"Ak" = (
/obj/machinery/atmospherics/pipe/simple/scrubbers/hidden/layer4{
	dir = 4
	},
/turf/open/floor/plasteel/dark,
/area/ship/cargo)
"Bm" = (
/obj/effect/turf_decal/corner/opaque/syndiered/diagonal,
/obj/machinery/atmospherics/pipe/simple/supply/hidden/layer2{
	dir = 4
	},
/turf/open/floor/plasteel/dark,
/area/ship/engineering)
"BQ" = (
/turf/closed/wall/mineral/plastitanium,
/area/ship/medical)
"BR" = (
/obj/effect/turf_decal/corner/opaque/syndiered/diagonal,
/obj/machinery/atmospherics/pipe/simple/scrubbers/hidden/layer4{
	dir = 4
	},
/turf/open/floor/plasteel/dark,
/area/ship/engineering)
"Cl" = (
/obj/structure/fans/tiny,
/obj/machinery/door/airlock/external,
/obj/machinery/atmospherics/pipe/simple/scrubbers/hidden/layer4{
	dir = 8
	},
/turf/open/floor/plasteel/dark,
/area/ship/cargo)
"Cx" = (
/obj/machinery/power/apc/auto_name/south,
/obj/structure/cable/yellow{
	icon_state = "0-4"
	},
/obj/machinery/atmospherics/pipe/simple/scrubbers/hidden/layer4{
	dir = 4
	},
/obj/machinery/atmospherics/pipe/simple/supply/hidden/layer2{
	dir = 5
	},
/turf/open/floor/plasteel/dark,
/area/ship/cargo)
"Gb" = (
/obj/structure/table,
/obj/item/storage/toolbox/syndicate,
/turf/open/floor/plasteel/dark,
/area/ship/cargo)
"Gi" = (
/obj/machinery/door/airlock/medical/glass,
/turf/open/floor/plasteel/dark,
/area/ship/medical)
"Gm" = (
/obj/effect/turf_decal/corner/opaque/syndiered/diagonal,
/obj/machinery/atmospherics/pipe/simple/scrubbers/hidden/layer4{
	dir = 10
	},
/turf/open/floor/plasteel/dark,
/area/ship/medical)
"Hr" = (
/obj/machinery/power/shuttle/engine/fueled/expulsion{
	dir = 4
	},
/turf/open/floor/plating,
/area/ship/engineering)
"Hw" = (
/obj/effect/turf_decal/corner/opaque/syndiered/diagonal,
/turf/open/floor/plasteel/dark,
/area/ship/cargo)
"HH" = (
/obj/effect/turf_decal/corner/opaque/syndiered/diagonal,
/turf/open/floor/plasteel/dark,
/area/ship/engineering)
"HL" = (
/obj/machinery/atmospherics/pipe/simple/supply/hidden/layer2{
	dir = 4
	},
/turf/open/floor/plasteel/dark,
/area/ship/engineering)
"HU" = (
/obj/structure/cable/yellow{
	icon_state = "2-4"
	},
/obj/structure/cable/yellow{
	icon_state = "4-8"
	},
/turf/open/floor/plasteel/dark,
/area/ship/engineering)
"HV" = (
/turf/open/floor/plasteel/dark,
/area/ship/bridge)
"IO" = (
/obj/effect/turf_decal/corner/opaque/syndiered/diagonal,
/obj/machinery/atmospherics/pipe/simple/scrubbers/hidden/layer4{
	dir = 8
	},
/obj/machinery/atmospherics/pipe/simple/supply/hidden/layer2{
	dir = 4
	},
/turf/open/floor/plasteel/dark,
/area/ship/bridge)
"JU" = (
/obj/machinery/cryopod{
	dir = 8
	},
/obj/machinery/computer/cryopod{
	dir = 8;
	pixel_x = 23
	},
/turf/open/floor/plasteel/dark,
/area/ship/medical)
"Kh" = (
/obj/machinery/mineral/ore_redemption{
	dir = 4;
	input_dir = 2;
	output_dir = 4
	},
/obj/effect/turf_decal/corner/opaque/syndiered/diagonal,
/turf/open/floor/plasteel/dark,
/area/ship/engineering)
"Kt" = (
/obj/structure/cable/yellow{
	icon_state = "1-2"
	},
/obj/machinery/atmospherics/pipe/simple/orange/hidden{
	dir = 9
	},
/obj/structure/catwalk/over,
/obj/structure/cable/yellow{
	icon_state = "1-4"
	},
/turf/open/floor/plating,
/area/ship/engineering)
"Kv" = (
/turf/closed/wall/mineral/plastitanium,
/area/ship/bridge)
"KI" = (
/turf/closed/wall/mineral/plastitanium/nodiagonal,
/area/ship/bridge)
"Lh" = (
/obj/structure/cable/yellow{
	icon_state = "1-8"
	},
/obj/structure/cable/yellow{
	icon_state = "4-8"
	},
/obj/machinery/atmospherics/pipe/manifold/scrubbers/hidden/layer4,
/obj/machinery/atmospherics/pipe/manifold/supply/hidden/layer2,
/turf/open/floor/plasteel/dark,
/area/ship/engineering)
"LZ" = (
/obj/structure/cable/yellow{
	icon_state = "2-8"
	},
/obj/structure/cable/yellow{
	icon_state = "2-4"
	},
/obj/effect/turf_decal/corner/opaque/syndiered/diagonal,
/obj/machinery/atmospherics/pipe/manifold/scrubbers/hidden/layer4{
	dir = 1
	},
/obj/machinery/atmospherics/pipe/manifold/supply/hidden/layer2{
	dir = 1
	},
/turf/open/floor/plasteel/dark,
/area/ship/cargo)
"Mo" = (
/obj/structure/cable/yellow{
	icon_state = "1-8"
	},
/obj/machinery/atmospherics/pipe/simple/supply/hidden/layer2{
	dir = 9
	},
/turf/open/floor/plasteel/dark,
/area/ship/medical)
"Ms" = (
/obj/structure/catwalk/over,
/obj/machinery/atmospherics/pipe/manifold/orange/hidden,
/turf/open/floor/plating,
/area/ship/engineering)
"MA" = (
/obj/structure/cable/yellow{
	icon_state = "1-2"
	},
/obj/machinery/atmospherics/pipe/simple/supply/hidden/layer2{
	dir = 6
	},
/turf/open/floor/plasteel/dark,
/area/ship/medical)
"Ne" = (
/obj/machinery/computer/cargo/express{
	dir = 8
	},
/turf/open/floor/plasteel/dark,
/area/ship/bridge)
"Nl" = (
/obj/machinery/computer/operating{
	dir = 8
	},
/turf/open/floor/plasteel/dark,
/area/ship/medical)
"Nn" = (
/obj/structure/cable/yellow{
	icon_state = "2-4"
	},
/obj/machinery/atmospherics/pipe/simple/scrubbers/hidden/layer4{
	dir = 6
	},
/obj/machinery/atmospherics/pipe/simple/supply/hidden/layer2{
	dir = 6
	},
/turf/open/floor/plasteel/dark,
/area/ship/engineering)
"NZ" = (
/obj/structure/chair/comfy/shuttle{
	dir = 1
	},
/obj/effect/turf_decal/corner/opaque/syndiered/diagonal,
/turf/open/floor/plasteel/dark,
/area/ship/cargo)
"OF" = (
/obj/machinery/atmospherics/components/unary/vent_scrubber/on/layer4{
	dir = 4
	},
/turf/open/floor/plasteel/dark,
/area/ship/engineering)
"PB" = (
/obj/effect/spawner/structure/window/plasma/reinforced/plastitanium,
/turf/open/floor/plating,
/area/ship/engineering)
"Qv" = (
/obj/machinery/atmospherics/pipe/simple/orange/hidden{
	dir = 10
	},
/obj/structure/catwalk/over,
/turf/open/floor/plating,
/area/ship/engineering)
"Ro" = (
/turf/template_noop,
/area/template_noop)
"RI" = (
/obj/machinery/autolathe,
/obj/effect/turf_decal/corner/opaque/syndiered/diagonal,
/turf/open/floor/plasteel/dark,
/area/ship/cargo)
"RJ" = (
/obj/machinery/atmospherics/components/unary/outlet_injector/on/layer4{
	dir = 4
	},
/turf/open/floor/plating,
/area/ship/external)
"RW" = (
/obj/machinery/atmospherics/pipe/simple/scrubbers/hidden/layer4{
	dir = 10
	},
/obj/machinery/atmospherics/pipe/simple/supply/hidden/layer2{
	dir = 10
	},
/turf/open/floor/plasteel/dark,
/area/ship/bridge)
"Tj" = (
/obj/machinery/atmospherics/components/unary/vent_scrubber/on/layer4{
	dir = 4
	},
/turf/open/floor/plasteel/dark,
/area/ship/medical)
"Ui" = (
/obj/effect/turf_decal/corner/opaque/syndiered/diagonal,
/obj/structure/cable/yellow{
	icon_state = "4-8"
	},
/turf/open/floor/plasteel/dark,
/area/ship/engineering)
"Ux" = (
/obj/structure/cable/yellow{
	icon_state = "1-2"
	},
/obj/effect/turf_decal/corner/opaque/syndiered/diagonal,
/obj/machinery/atmospherics/pipe/simple/scrubbers/hidden/layer4,
/obj/machinery/atmospherics/pipe/manifold/supply/hidden/layer2{
	dir = 4
	},
/turf/open/floor/plasteel/dark,
/area/ship/engineering)
"UI" = (
/obj/machinery/computer/helm{
	dir = 8
	},
/obj/effect/turf_decal/corner/opaque/syndiered/diagonal,
/turf/open/floor/plasteel/dark,
/area/ship/bridge)
"UM" = (
/obj/effect/turf_decal/corner/opaque/syndiered/diagonal,
/obj/machinery/atmospherics/pipe/simple/scrubbers/hidden/layer4{
	dir = 9
	},
/obj/machinery/atmospherics/pipe/simple/supply/hidden/layer2{
	dir = 5
	},
/turf/open/floor/plasteel/dark,
/area/ship/bridge)
"VF" = (
/obj/structure/cable/yellow{
	icon_state = "4-8"
	},
/obj/machinery/atmospherics/pipe/simple/scrubbers/hidden/layer4{
	dir = 4
	},
/obj/machinery/atmospherics/pipe/simple/supply/hidden/layer2{
	dir = 4
	},
/turf/open/floor/plasteel/dark,
/area/ship/medical)
"VZ" = (
/obj/machinery/atmospherics/components/unary/vent_pump/on/layer2{
	dir = 8
	},
/turf/open/floor/plasteel/dark,
/area/ship/cargo)
"Wc" = (
/turf/open/floor/plasteel/dark,
/area/ship/cargo)
"Wk" = (
/obj/structure/closet/crate/engineering,
/obj/item/circuitboard/computer/selling_pad_control,
/obj/item/circuitboard/machine/selling_pad,
/obj/machinery/light{
	dir = 8
	},
/obj/effect/turf_decal/corner/opaque/syndiered/diagonal,
/obj/machinery/airalarm/all_access{
	pixel_y = 25
	},
/obj/item/storage/box/rndboards,
/turf/open/floor/plasteel/dark,
/area/ship/engineering)
"WA" = (
/obj/structure/table/optable,
/obj/machinery/light/small{
	dir = 1
	},
/obj/effect/turf_decal/corner/opaque/syndiered/diagonal,
/turf/open/floor/plasteel/dark,
/area/ship/medical)
"WY" = (
/obj/structure/chair/comfy/shuttle{
	dir = 4;
	name = "Helm"
	},
/turf/open/floor/plasteel/dark,
/area/ship/bridge)
"Xa" = (
/obj/structure/cable/yellow{
	icon_state = "4-8"
	},
/turf/open/floor/plasteel/dark,
/area/ship/engineering)
"XD" = (
/obj/machinery/door/poddoor{
	id = "rundowncargo";
	name = "IMS-730 Bay Blast Door"
	},
/obj/docking_port/mobile{
	dir = 8
	},
/obj/machinery/power/shieldwallgen/atmos/roundstart{
	id = "hyena_cargo";
	locked = 1
	},
/obj/structure/cable/yellow{
	icon_state = "0-8"
	},
/turf/open/floor/plasteel/dark,
/area/ship/engineering)
"YQ" = (
/obj/structure/table,
/obj/item/pipe_dispenser,
/turf/open/floor/plasteel/dark,
/area/ship/cargo)
"Zx" = (
/obj/structure/table,
/obj/item/areaeditor/shuttle,
/obj/machinery/light{
	dir = 8
	},
/obj/item/gps,
/turf/open/floor/plasteel/dark,
/area/ship/bridge)
"ZU" = (
/obj/machinery/button/door{
	pixel_y = -23;
	pixel_x = 6;
	id = "rundowncargo";
	name = "cargo door button"
	},
/obj/effect/turf_decal/corner/opaque/syndiered/diagonal,
/obj/machinery/button/shieldwallgen{
	dir = 1;
	id = "hyena_cargo";
	pixel_x = -10;
	pixel_y = -24
	},
/obj/structure/cable/yellow{
	icon_state = "1-4"
	},
/turf/open/floor/plasteel/dark,
/area/ship/engineering)

(1,1,1) = {"
Ro
Ro
Ro
Ro
RJ
Ro
Ro
Hr
Hr
Ro
Hr
Hr
Ro
Ro
"}
(2,1,1) = {"
Ro
Ro
Ro
Ro
sz
wt
wt
dk
dk
wt
dk
dk
wt
wt
"}
(3,1,1) = {"
qD
qD
qD
qD
Cl
wt
Wk
Qv
Ms
vi
qz
Kt
wL
wt
"}
(4,1,1) = {"
qD
RI
fg
Hw
Ak
wt
lj
tJ
do
gD
do
Ui
me
wt
"}
(5,1,1) = {"
qD
YQ
NZ
gl
by
PB
HH
HL
Qv
pH
bZ
Xa
xD
wt
"}
(6,1,1) = {"
qD
nZ
rx
pM
aR
PB
iW
Bm
OF
aW
hO
Ui
iW
wt
"}
(7,1,1) = {"
qD
Gb
NZ
Wc
by
PB
HH
HL
BR
wi
Bm
Xa
Kh
wt
"}
(8,1,1) = {"
qD
cK
Wc
gz
Cx
wt
Nn
Ux
fh
lb
gK
Ui
iW
wt
"}
(9,1,1) = {"
qD
iJ
Hw
VZ
LZ
vG
Lh
aV
di
dQ
di
HU
ZU
wt
"}
(10,1,1) = {"
BQ
mx
mx
mx
fR
BQ
oX
Kv
Kv
Kv
KI
XD
gN
wt
"}
(11,1,1) = {"
BQ
WA
Tj
wj
VF
mx
rN
jb
Zx
fM
Kv
Ro
Ro
Ro
"}
(12,1,1) = {"
BQ
Nl
Gm
aU
iP
mx
IO
wm
jf
HV
Kv
Ro
Ro
Ro
"}
(13,1,1) = {"
BQ
kj
MA
cR
Mo
mx
RW
UM
WY
xP
Kv
Ro
Ro
Ro
"}
(14,1,1) = {"
BQ
dR
wp
JU
wj
Gi
zz
eA
UI
Ne
Kv
Ro
Ro
Ro
"}
(15,1,1) = {"
BQ
BQ
BQ
BQ
BQ
BQ
Kv
mh
mh
mh
Kv
Ro
Ro
Ro
"}
